1 1 1 1 1 1 1 1 1 1 1 1 1 1 1 1
1 1 1 1 1 1 1 1 1 1 1 1 1 1 1 1
1 1 1 1 1 1 1 1 1 1 1 1 1 1 1 1
2 2 2 2 2 2 2 2 2 2 2 2 2 2 2 2
3 0 0 0 0 0 0 0 0 0 0 0 0 0 0 7
3 0 0 0 0 0 0 0 0 0 0 0 0 0 0 7
3 0 0 0 0 0 0 0 0 0 0 0 0 0 0 7
3 0 0 0 0 0 0 0 0 0 0 0 0 0 0 0
3 0 0 0 0 0 0 0 0 0 0 0 0 0 0 7
3 0 0 0 0 0 0 0 0 0 0 0 0 0 0 7
3 0 0 0 0 0 0 0 0 0 0 0 0 0 0 7
4 5 5 5 5 5 5 5 5 5 0 0 5 5 5 6

0 = floor.png
1 = basic-wall.png
2 = wall-bottom.png
3 = left-wall.png
4 = left-corner.png
5 = bottom-wall.png
6 = right-corner.png
7 = right-wall.png
